# Lucy the Diamond Girl map v1.0
IS_INTERMISSION=0
TIME=90
GAME_SPEED=6
AMEBA_TIME=0
DIAMOND_SCORE=10
TIME_SCORE=1
DIAMONDS_NEEDED=12
WIDTH=25
HEIGHT=20
BACKGROUND_TYPE=0

DIAMOND=!
SAND=%
BOULDER=*
BRICK=#
BRICK_EXPANDING=z
BRICK_MORPHER=x
BRICK_UNBREAKABLE=Z
AMEBA=a
SLIME=s
EMPTY=.
ENEMY1=1
ENEMY2=2
START=S
END=E

DATA=
ZZZZZZZZZZZZZZZZZZZZZZZZZ
ZSEZ%%%%%%%%%%%%%%%%%%%%Z
Z%ZZ%Z%Z%%Z%Z%%Z%Z%%Z%Z%Z
Z%ZZZ%%%ZZ%%%ZZ%%%ZZ%%%ZZ
Z%ZZ%!!!%%!!!%%!!!%%!!!%Z
Z%ZZ%***%%***%%***%%***%Z
Z%ZZ%***%%***%%***%%***%Z
Z%ZZ%***%%***%%***%%***%Z
Z%ZZZ%%%ZZ%%%ZZ%%%ZZ%%%ZZ
Z%ZZ%Z%Z%%Z%Z%%Z%Z%%Z%Z%Z
Z%ZZ%%%%%%%%%%%%%%%%%%%%Z
Z%ZZ%%%%%%%%%%%%%%%%%%%%Z
Z%ZZ%%%%%%%%%%%%%%%%%%%%Z
Z%ZZ%%%%%%%%%%%%%%%%%%%%Z
Z%ZZ%%%%%%%%%%%%%%%%%%%%Z
Z%ZZ%%%%%%%%%%%%%%%%%%%%Z
Z%ZZ%%%%%%%%%%%%%%%%%%%%Z
Z%ZZ%%%%%%%%%%%%%%%%%%%%Z
Z%%%%%%%%%%%%%%%%%%%%%%%Z
ZZZZZZZZZZZZZZZZZZZZZZZZZ
