# Diamond Girl map v1.0
IS_INTERMISSION=0
TIME=60
GAME_SPEED=3
AMEBA_TIME=300
DIAMOND_SCORE=2
TIME_SCORE=1
DIAMONDS_NEEDED=20
WIDTH=31
HEIGHT=12
BACKGROUND_TYPE=0

DIAMOND=!
SAND=%
BOULDER=*
BRICK=#
BRICK_EXPANDING=z
BRICK_MORPHER=x
BRICK_UNBREAKABLE=Z
AMEBA=a
EMPTY=.
ENEMY1=1
ENEMY2=2
START=S
END=E

DATA=
###############################
#%%%%%**%%%%%%%!%%#%%**%%%!%%*#
#%*%!%**%!%%%%%%%%*%!***%%%!%%#
#%%%%%%***%%%%*%%%#%#*#%#%#%#%#
#%%%%!%%***%!%%%%%%!%**%%!%%%%#
#%*%%%*%%%**%%%%*%%%%%****%*%%#
#%%%%%%%%%%**!%%%%%*%%******%!#
#%%!*%%%!%%%**%%!%%%%%********#
#%%%%%%*%%*%%****%%%!*****%%%%#
#E%%%%%%%%%%!%****%%%%%%!%*%%%#
#S%%%!%%%%%*%%%%**!*%%%%%%%%%%#
###############################
